####################
#..................#
#...1..###...1.....#
#......###.........#
#..................#
#.....$...X........#
#..................#
#...2..###...2.....#
#......###.........#
#..................#
#.....$...X........#
#..................#
#..@...............#
####################
